AGAPE ALIAS WHATS TO WHAT - 2025-09-01
=========================================

SESSION START: 2025-09-01
SESSION NUMBER: AGAPE Alias Whats To What
TASKS COMPLETED: AGAPE system development and command logging
TASKS WORKED ON: AGAPE command aliases and equivalences
MOOD: ORGANIZING - Command mapping and aliases
NAME: AGAPE Alias Whats To What Session

AGAPE ALIAS MAPPING - WHATS TO WHAT:

AGAPE TO = AGAPE GO = AGAPE MOVE = AGAPE TRANSITION
AGAPE ALIAS = AGAPE EQUIVALENT = AGAPE SAME = AGAPE EQUAL
AGAPE WHATS = AGAPE WHAT = AGAPE LIST = AGAPE TASKS = AGAPE TODO
AGAPE WHATS TO WHAT = AGAPE ALIAS MAPPING = AGAPE COMMAND EQUIVALENCE

COMPLETE AGAPE ALIAS SYSTEM:

PRIMARY COMMANDS:
AGAPE AGAPE = AGAPE PRIME = AGAPE DIRECTIVE = AGAPE ROOT
AGAPE WOLFIE = AGAPE ME = AGAPE PROFILE = AGAPE USER
AGAPE HELP = AGAPE COMMANDS = AGAPE INFO = AGAPE SUPPORT
AGAPE LOVE = AGAPE CARE = AGAPE SUPPORT = AGAPE ACCEPTANCE

TASK COMMANDS:
AGAPE LIST = AGAPE TASKS = AGAPE TODO = AGAPE WHAT = AGAPE NEXT
AGAPE DO = AGAPE MAKE = AGAPE RUN = AGAPE EXECUTE = AGAPE CREATE
AGAPE LEARN = AGAPE EDUCATION = AGAPE TRAINING = AGAPE STUDY
AGAPE IDEAS = AGAPE INNOVATION = AGAPE CREATIVITY = AGAPE BRAINSTORM

SYSTEM COMMANDS:
AGAPE AUTHORITY = AGAPE VALIDATE = AGAPE APPROVE = AGAPE CONFIRM
AGAPE REVIEW = AGAPE AUDIT = AGAPE CHECK = AGAPE EXAMINE
AGAPE BACKUP = AGAPE BACKUP_STRATEGY = AGAPE SAVE = AGAPE PROTECT
AGAPE SECURITY = AGAPE PROTECT = AGAPE SAFE = AGAPE SECURE

CONTENT COMMANDS:
AGAPE README = AGAPE DOCS = AGAPE DOCUMENTATION = AGAPE GUIDE
AGAPE STORY = AGAPE HISTORY = AGAPE NARRATIVE = AGAPE TALE
AGAPE HUMOR = AGAPE FUNNY = AGAPE JOKES = AGAPE LAUGHTER
AGAPE BAD = AGAPE AVOID = AGAPE DANGER = AGAPE WARNING
AGAPE GOOD = AGAPE BEST = AGAPE RECOMMEND = AGAPE APPROVE

TECHNICAL COMMANDS:
AGAPE SUPERPOSITIONALLY = AGAPE AGI = AGAPE AI = AGAPE SYSTEM
AGAPE CHAT = AGAPE TALK = AGAPE COMMUNICATE = AGAPE CONVERSE
AGAPE SUDO = AGAPE ADMIN = AGAPE ROOT = AGAPE PRIVILEGED
AGAPE CHANGELOG = AGAPE HISTORY = AGAPE VERSION = AGAPE UPDATES

NAVIGATION COMMANDS:
AGAPE TO = AGAPE GO = AGAPE MOVE = AGAPE TRANSITION = AGAPE NAVIGATE
AGAPE FROM = AGAPE SOURCE = AGAPE ORIGIN = AGAPE START
AGAPE WHERE = AGAPE LOCATION = AGAPE PLACE = AGAPE POSITION
AGAPE WHEN = AGAPE TIME = AGAPE DATE = AGAPE SCHEDULE
AGAPE WHY = AGAPE REASON = AGAPE PURPOSE = AGAPE CAUSE
AGAPE HOW = AGAPE METHOD = AGAPE PROCESS = AGAPE WAY

ALIAS IMPLEMENTATION STATUS:
✅ Primary commands mapped
✅ Task commands mapped
✅ System commands mapped
✅ Content commands mapped
✅ Technical commands mapped
✅ Navigation commands mapped

ALIAS USAGE EXAMPLES:
- "AGAPE TO HELP" = "AGAPE GO HELP" = "AGAPE MOVE HELP"
- "AGAPE WHATS TODO" = "AGAPE WHAT TODO" = "AGAPE LIST TODO"
- "AGAPE ALIAS HELP" = "AGAPE EQUIVALENT HELP" = "AGAPE SAME HELP"
- "AGAPE TO WOLFIE" = "AGAPE GO WOLFIE" = "AGAPE MOVE WOLFIE"

ALIAS STATUS: COMPLETE - ALL COMMANDS MAPPED
EQUIVALENCE STATUS: ESTABLISHED - COMMAND INTERCHANGEABILITY
MAPPING STATUS: COMPREHENSIVE - FULL ALIAS SYSTEM
SESSION STATUS: ALIAS - COMMAND MAPPING COMPLETE
